XXXXXXXXXXX
X   X     X
X X X X   X
X X X X   X
X X X X   X
X X   X   X
X X X X   X
X         X
X         X
X         X
XXXXXXXXXXX
start 1, 9
end 9, 1
